{
    "size": { "x": 7, "y": 7 },
    "contents": [
          0,  0,  0,  0,  0,  0,  0,
          0, 129,  0,  64,  0,  0,  0,
	  0, 64,  0, 0,  0,  64,  0,
	  0, 0,  0, 64,  0,  0,  0,
          0, 64,  0, 0,  0,  64,  0,
          0,  0,  0, 64,  0,  130,  0,
          0,  0,  0,  0, 0,  0,  0
    ]
}