{
    "size": { "x": 10, "y": 10 },
    "contents": [
        129,  0,  0,  0,  0,  0,  0,  0,  0,  0,
          0, 64,  0,  0,  0,  0,  0,  0,  0,  0,
          0, 64, 64, 64, 64,  0,  0,  0,  0,  0,
          0,  0,  0, 64,  0,  0, 64, 64,  0,  0,
          0,  0,  0,  0,  0,  0,  0, 64, 64,  0,
	  0, 64,  0,  0,  0,  0,  0, 64,  0,  0,
          0,  0,  0,  0,  0,  0,  0,  0,  0,  0,
          0, 64, 64, 64,  0,  0,  0,  0,  0,  0,
          0,  0,  0,  0,  0,  0,  0,  0,  0,  0,
          0,  0,  0,  0,  0,  0,  0,  0,  0,130
    ]
}